WWWWWWWWWW
WW  KWW KW
WW WWWW WW
WW      WW
WWWWWWW WW
WW   WW WW
WK W    WW
WWWWSWWWWW
WWWWDWWWWW
WWWWFWWWWW