WWWW WWWWW
WW   WWWWW
WW WWWWWWW
WW      WW
WWWWWWW WW
WW   WW WW
W  W    WW
WWWW WWWWW