WWWWWWWWWWWWWWW
WW  KWW     WWW
WW WWWW WWW WWW
WW      WW   WW
WWWWWWW WW W WW
WW   WW W  W WW
WK W    W WW WW
WWWWSWWWW KWWWW
WWWWDWWWWWWWWWW
www^^wwwwwwwwww
www^www^^^^^^^w
www^^ww^ww^wwww
ww^w^wwwww^w^ww
ww^w^^^^ww^^^ww
ww^wwww^^^^wwww
wwww^ww^ww^wwww
F^ww^ww^ww^wwww
w^ww^^^^ww^^^^w
w^^^^www^^^wwww
wwwwwwwwwwwwwww