WWWWWWWWWWWWWWW
WW  KWW     WWW
WW WWWW WWW WWW
WW      WW   WW
WWWWPWW WW W WW
WW   WW W  W WW
WK WKKK W WW WW
WWWWSWWWW KWWWW
WWWTDTWWWWWWWWW
www^twwwwwwwwww
www^www^^^^^^kw
www^^ww^ww^wwww
ww^w^wwwww^wkww
ww^w^^^^ww^^^ww
ww^wwww^^^^wwww
wwwwkww^ww^wwww
F^ww^ww^ww^wwww
w^ww^^^^ww^^^^w
w^d^^www^^^wwww
wwwwwwwwwwwwwww