WWWWWWWWWWWWWWW
WW  KWW     WWW
WW WWWW WWW WWW
WW      WW   WW
WWWWWWW WW W WW
WW   WW W  W WW
WK W    W WW WW
WWWWSWWWW KWWWW
WWWWDWWWWWWWWWW
www^^wwwwwwwwww
www^www^^^^^^kw
www^^ww^ww^wwww
ww^w^wwwww^wkww
ww^w^^^^ww^^^ww
ww^wwww^^^^wwww
wwwwkww^ww^wwww
F^ww^ww^ww^wwww
w^ww^^^^ww^^^^w
w^d^^www^^^wwww
wwwwwwwwwwwwwww