WWWWFWWWWW
WW   WW  W
WW WWWW WW
WW      WW
WWWWWWW WW
WW   WW WW
W  W    WW
WWWWSWWWWW
WWWWWWWWWW